Мужчина едет на велосипеде.	Едет человек на велосипеде.
Женщина и мужчина танцуют под дождем.	Мужчина и женщина танцуют под дождем.
Кто-то рисует.	Кто-то танцует.
Мужчина и женщина целуют друг друга.	Мужчина и женщина разговаривают друг с другом.
Женщина нарезает лук.	Женщина режет лук.
Человек чистит креветки.	Человек готовит креветки.
Женщина режет брокколи.	Женщина нарезает брокколи.
Мужчина играет на гитаре.	Женщина играет на гитаре.
Двое мужчин дерутся на кулаках на ринге.	Двое мужчин дерутся кулаками на ринге.
Маленький мальчик играет с собакой.	Ребенок играет с собакой.
Рисует мужчина.	Мужчина рисует.
Мужчина жерет картофель.	Женщина режет помидор.
Маленькая собачка лежит на кровати.	Маленькая собачка лежит на постели.
Человек вытирает масло на подносе.	Человек намазывает маслом поднос.
Двое мужчин играют в футбол.	Двое мужчин занимаются футболом.
Мужчина играет на гитаре.	Девушка играет на гитаре.
Мужчина нарезает картофель.	Нарезает картофель мужчина.
Мальчик играет на гитаре.	Ребенок играет на гитаре.
Мужчина нарезает картошку.	Нарезает картошку мужчина.
Мужчина чистит картошку.	Мужчина нарезает картофель.
Женщина колет картошку вилкой.	Женщина прокалывает вилкой картошку.
Ребенок просыпается.	Девушка просыпается.
Мальчик играет на клавиатуре.	Маленький мальчик играет на клавиатуре.
Женщина режет лук.	Женщина режет лук.
Игрушечный поезд врезается в игрушечный вагон.	Игрушечный поезд врезается в игрушечный вагон.
Человек играет на гитаре.	Мужчина играет на флейте.
Кошка открывает ящик и забирается внутрь.	Кошка открывает ящик и забирается в него.
Женщина жарит еду.	Женщина жарит пищу во фритюре.
Женщина играет на флейте.	Женщина играет на флейте.
Мужчина нарезает кубиками лук.	Женщина режет лук.
Девушка играет на гитаре.	Мужчина играет на гитаре.
Девушка поет на сцене.	Человек поет на сцене.
Женщина верхом на лошади.	Женщина верхом на осле.
Девушка играет на гитаре.	Мужчина играет на гитаре.
Женщина чистит креветки.	Женщина чистит креветки.
Человек танцует на потолке.	Мужчина танцует на потолке комнаты.
Женщина играет на электрогитаре.	Мужчина играет на акустической гитаре.
Женщина тонко нарезает лук большим ножом.	Женщина нарезает лук большим ножом.
Мужчина играет на клавишных.	Мужчина играет на клавишных.
Мужчина играет на гитаре.	Человек играет на гитаре.
Женщина чистит картофель.	Женщина чистит картошку.
Женщина занимается лягушку.	Мужчина держит лягушка.
Человек чистит креветки.	Мужчина чистит креветки.
Человек играет на флейте.	Мужчина играет на гитаре.
Человек играет на флейте.	Мужчина играет на гитаре.
Мужчина играет на гитаре.	Человек играет на флейте.
Мужчина играет на фортепиано.	Мужчина играет на гитаре.
Мужчина играет на гитаре.	Мужчина играет на фортепиано.
Человек играет на флейте.	Мужчина играет на гитаре.
Человек играет на флейте.	Мужчина играет на гитаре.
Две женщины сидят на диване.	Две женщины обнимаются на диване.
Кто-то нарезает огурец.	Человек нарезая огурец.
Котенок играет с голубой веревкой игрушкой.	Котенок играет с игрушкой.
Группа людей выметает воду из дома.	Люди выметают воду из дома.
Собака лает на игрушку.	Собака лает на игрушку.
Человек складывает тортилью.	Мужчина складывает тортилью.
Кошка пьет молоко.	Котенок пьет молоко.
Человек за рулем автомобиля.	Мужчина за рулем автомобиля.
Черепаха идет пешком.	Черепаха гуляет.
Корова ест траву.	Корова ест сено.
Женщина нарезает брокколи.	Женщина рубит чеснок.
Мужчина плачет.	Человек кричит.
Женщина надевает солнечные очки.	Женщина надевает солнечные очки.
Человек играет на гитаре.	Человек играет на гитаре.
Мужчина режет лук.	Человек резки подорожника.
Мужчина нарезает картофель.	Женщина чистит картофель.
Женщина нарезает картофель.	Женщина нарезает морковь.
Мужчина играет на гитаре.	Мужчина играет на гитаре.
Женщины бегут.	Две женщины работают.
Женщина постукивая пальцами по столу.	Женщина постукивая пальцами.
Кто-то варит бамию в котелке.	Кто-то готовит окру на сковороде.
Человек курит.	Мужчина смешивает людей.
Мужчина играет на барабанах.	Мужчина играет на барабанах.
Мужчина ныряет в бассейн.	Мужчина ныряет в бассейн.
Женщина сокращает утечку.	Женщина нарезает лук-порей.
Мужчина играет на арфе.	Женщина играет на гитаре.
Мужчина ныряет в бассейн.	Мужчина ныряет в бассейн.
Маленький мальчик играет на гитаре.	Мальчик играет на гитаре.
Человек разбивает чеснок.	Человек разбивает чеснок.
Мужчина режет картошку.	Человек режет морковь.
Женщина танцует.	Человек танцует.
Женщины разговаривают.	Мужчины разговаривают.
Девушка наносит гель на волосы.	Женщина наносит гель на волосы.
Ребенок играет на гитаре.	Мужчина играет на гитаре.
Группа людей марширует на месте.	Группа людей танцует на концерте.
Мужчина и женщина целуют друг друга.	Мужчина и женщина обнимаются и целуются.
Женщина стреляет из пулемета.	Мужчина стреляет из пистолета.
Мужчина играл на пианино.	Мужчина играет на пианино.
Женщина нарезает лук.	Кто-то нарезает лук.
Человек нарезая огурец.	Мужчина режет огурцы.
Девушка ест кекс.	Женщина ест кекс.
Женщина режет лук.	Человек рубит лук.
Мужчина играет на гитаре.	Ребенок играет на гитаре.
Человек играет на гитаре.	Мужчина играет на барабанах.
Две маленькие девочки разговаривают по телефону.	Две девушки разговаривают по телефону.
Мужчина рубит топором бревно.	Человек рубит дерево топором.
Женщина поднимается на скалу.	Женщина поднимается по скале.
Человек нарезая лук.	Мужчина нарезает лук ломтиками.
Белый медведь бежит навстречу группе моржей.	Белый медведь гонится за группой моржей.
Человек режет стручковый перец на куски.	Человек нарезает чеснок на кусочки.
Мужчина разговаривает с женщиной.	Женщина гуляет с собакой.
Человек ходит.	Говорит мужчина.
Кто-то наливает масло в сковородку.	Кто-то наливает молоко в блендер.
Маленький котенок играет в мяч.	Котенок играет с мячом.
Мужчина играет на гитаре.	Женщина играет на флейте.
Женщина режет рыбу.	Женщина режет тофу.
Девушка играет на скрипке.	Девочка играет на флейте.
Кто-то играет на пианино.	Кто-то играет на гитаре.
Мужчина играет на двух роялях.	Кошка играет на пианино.
Человек осуществляет.	Девочка делает зарядку.
Человек нарезает гребешок.	Человек нарезает осьминога.
Мужчина и женщина едут на велосипедах.	Мужчина и женщина едут на мотоцикле.
Мужчина наливает в кастрюлю рис с Рони.	Человек налил РИК-а-Рони в кастрюлю.
Двое мужчин дерутся на коровьем пастбище.	Двое мужчин дерутся в загоне для скота.
Женщина добавляет масло в кастрюлю.	Человек наливает масло на сковородку.
Девушка заправляет постель.	Молодая девушка заправляет постель.
Кот играл с арбузом.	Кот играет с арбузом.
Девушка прыгает на машине.	Девушка прыгает на машину.
Мужчина ломает деревянные доски рукой.	Мужчина ломает плитку руками.
Девушка играет на гитаре.	Девочка играет на пианино.
Человек молится.	Человек танцует.
Человек молится.	Человек работает.
Автомобиль находится на парковке.	Кошка играет.
Человек работает.	Человек танцует.
Человек танцует.	Мужчина поет.
Человек работает.	Мужчина поет.
Мужчина поет.	Человек танцует.
Мужчина несет другого мужчину через плечо.	Мужчина несет кого-то на плече.
Женщина чистит картофель.	Женщина нарезает помидор.
Женщина режет помидор.	Женщина нарезает картофель.
Кто-то чистит картошку.	Кто-то нарезает помидор.
Женщина чистит картофель.	Женщина нарезает помидор.
Два робота целуются.	Два робота целуются.
Два мальчика на диване играют в видеоигры.	Два мальчика играют в видеоигру.
Мужчина идет в поход по лесу.	Мужчина идет по следу в лесу.
Женщина сжимает лимон.	Женщина выжимает сок из лимона.
Человек играет на пианино.	Человек играет на скрипке.
Человек играет на флейте.	Человек играет на гитаре.
Человек езда на велосипеде.	Женщина верхом на лошади.
Женщина нарезает лук.	Человек нарезая помидор.
Женщина нарезает морковку.	Человек нарезая помидор.
Женщина нарезает лук.	Женщина нарезает лимоны.
Девушка укладывает волосы.	Девушка подшивает ногти.
Мужчина спускается по лестнице.	Мужчина спускается по лестнице.
Мужчина едет верхом на лошади по ручью.	Человек верхом на лошади.
Женщина играет на гитаре.	Человек играет на гитаре.
Мужчина играет на гитаре.	Мужчина играет на гитаре и поет.
Два человека едут на мотоцикле.	Два человека едут на велосипеде.
Мужчина играет на гитаре.	Женщина играет на электрогитаре.
Мужчина играет на гитаре и поет.	Мужчина играет на гитаре.
Человек идет под дождем.	Мужчина и женщина идут в Гранд.
Кенгуру уже кушает.	Кенгуру ест.
Мужчина ведет промысел.	Человек осуществляет.
Женщина-это плавание.	Мужчина поет.
Женщина ест.	Животное начинает есть.
Мальчик и девочка танцуют под дождем.	Мужчина и женщина танцуют под дождем.
Мужчина за рулем автомобиля.	Мужчина управляет автомобилем.
Женщина натирает лук на терке.	Женщина режет лук.
Два петуха дерутся.	Двое мужчин сражаются.
Человек верхом на лошади.	Мужчина за рулем автомобиля.
Человек верхом на лошади.	Мужчина за рулем автомобиля.
Человек ест пиццу.	Человек ест пищу.
Мужчина стреляет из пистолета.	Человек разрезает булочку.
Мужчина поднимает дерево.	Мужчина несет дерево.
Женщина режет лук.	Женщина резала мясо.
Женщина нарезает травы.	Мужчина нарезает хлеб.
Мальчик играет на пианино.	Мужчина играет на фортепиано.
Маленький слоненок ест.	Слоненок ест саженец.
Человек чистит картошку.	Мужчина чистит картошку.
Человек играет на пианино.	Человек нарезает картофель.
Женщина разбивать яйца в миску.	Женщина разбивает яйцаэк.
Человек играл на синтезаторе.	Мальчик играет на клавиатуре.
Мальчик бьет человека мечом.	Мальчик шлепает человека пластиковым мечом.
Человек нарезает морковь на кусочки.	Человек режет лук на кусочки.
Мужчина разрезал ножом кучу бутылок с водой.	Мужчина нарезает линию бутылок с водой ножом
Человек играет на гитаре.	Мужчина играет на гитаре.
Мужчина пишет книгу.	Человек пишет на бумаге.
Мужчина плюется.	Говорит мужчина.
Мужчина играет на музыкальной клавиатуре.	Мужчина играет на клавишных.
Женщина нарезает чеснок.	Женщина нарезает большой перец.
Человек застилает постель.	Человек ест за столом.
Мужчина намазывает хлеб маслом.	Человек перемешивает рис.
Женщина бьет мужчину.	Женщина принимает ванну.
Мужчина играет на клавишных.	Человек играет на гитаре.
Человек играет на скрипке.	Мужчина играет на арфе.
Трое мужчин танцуют.	Женщины танцуют.
Человек говорит.	Человек танцует.
Человек танцует.	Человек говорит.
Женщина является курение.	Человек ходит.
Человек танцует.	Человек думает.
Человек стер то, что было у другого человека на доске.	Человек стер работу на доске.
Человек на мотоцикле.	Мужчина едет на мотоцикле по городу.
Человек едет на мотоцикле по трассе.	Человек на мотоцикле.
Женщина нарезает мясо на куски.	Женщина нарезает лук.
Человек расчесывает кошачью шерсть.	Человек расчесывает кошку.
Женщина режет брокколи.	Женщина режет брокколи.
Мужчина играет на фортепиано.	Женщина чистит картофель.
Кто-то нарезает помидор.	Кто-то нарезает фрукты.
Женщина танцует в клетке.	Женщина танцует.
Женщина-это плавание.	Мужчина плюется.
Человек работает.	Человек мычит.
Человек играет на гитаре.	Мужчина играл на своей гитаре.
Кошка смотрит в камеру.	Кошка обращается к камере.
Ребенок смеется и ползает.	Ребенок смеется и ползает по полу.
Мужчина играет на трубе.	А человек играет на трубе.
Женщина стреляет из пистолета.	Женщина стреляет из дробовика.
Мужчина играет на барабанах.	Человек играет на гитаре.
Женщина танцует под дождем.	Женщина танцует на железнодорожном вокзале.
Женщина верхом на лошади.	Мужчина едет верхом на лошади.
Женщина танцует.	Женщина делает зарядку.
Ребенок играет на музыкальном инструменте.	Мальчик играет на духовом инструменте.
Кто-то разрезает бутылку мечом.	Мужчина разбивает бутылку мечом.
Человек чистит банан.	Женщина чистит картофель.
Женщина режет яблоко.	Женщина режет картошку.
Мужчина чистит яблоко.	Мужчина чистит яблоко от кожуры.
Мальчик верхом на лошади.	Обезьяна едет на автобусе.
Щенок пытался выбраться из ванны.	Щенок пытается выбраться из ванны.
Человек играет на гитаре.	Мужчина играет с черепом.
Животное ходит по земле.	По земле идет соленодон.
Группа играет на сцене.	Женщина танцует на сцене.
Женщина играет на гитаре и поет.	Женщина играет на гитаре.
Маленькая девочка играет на рояле на сцене.	Маленькая девочка играет на пианино.
Мужчина начинает есть.	Мужчина принимает пищу.
Группа людей танцует.	Группа мужчин танцует.
Мужчина играет на гитаре.	Женщина играет на гитаре.
Маленький мальчик бьет по мячу для гольфа.	Маленький мальчик замахнулся на мяч для гольфа.
Кошка качается на потолочном вентиляторе.	Кот вращается вокруг потолочного вентилятора.
Парень снимает солнечные очки.	Мальчик, снимая очки.
Кто-то читает письмо.	Человек читает свою электронную почту.
Женщина играет на флейте.	Девочка играет на флейте.
Женщина нарезает кубиками лук.	Женщина режет лук.
Обезьяна расчесывает быка.	Обезьяна расчесывает собаку.
Человек нарезает лук.	Кто-то нарезает лук.
Женщина нарезает лук.	Женщина режет картошку.
Человек играет на пианино.	Женщина играет на гитаре.
Женщина моет руки.	Женщина поправляет волосы.
Женщина стреляет из дробовика.	Женщина стреляет из пистолета.
Мужчина ест тарелку с хлопьями.	Мужчина ест хлопья.
Девушка подъезжает на машине.	Девушка прыгает на машину сверху.
Женщина купается в ванной.	Женщина принимает ванну.
Мотоциклист падает на мотоцикл.	Человек падает на мотоцикл.
Мужчина подвешивает мышь возле змеи.	Человек кормит змею мышами.
Мужчина и женщина идут по лесу-разн.	Мужчина и женщина идут по джунглям.
Человек наливает рисовый пудинг в миску.	Дама налила рисовый пудинг в миску.
Мужчина смотрит в окно.	Мужчина смотрит в окно.
Женщина стреляет из винтовки.	Женщина режет лимон.
Человек ест банан.	Кто-то чистит банан.
Мужчины выступают на сцене.	На сцене выступали комедийные мимы.
Мультипликационная женщина ныряет в бассейн.	Женщина из мультфильма ныряет с доски.
Женщина положила ребенка в мусорку.	Женщина кладет ребенка в мусорный бак.
Кто-то жарит мясо.	Кто-то играет в paino.
Человек быстро рубит грибы ножом.	Человек быстро рубит грибы ножом.
Женщина добавляет ингредиенты в миску.	Женщина разбивает три яйца в миску.
Скейтбордист, делает трюки на хаф-пайп.	Мужчина катается на скейтборде на трубе.
Человек выступает на сцене.	Мужчина выступает на трибуне.
Мужчина играет на гитаре.	Мужчина в шляпе играет на арфе.
Человек играет на клавиатуре.	Мужчина играет на гитаре.
Человек режет картошку.	Человек нарезает лук-шалот.
Мужчина играет на барабанах.	Человек играет на гитаре.
Мужчина танцует на потолке комнаты.	Мужчина танцует вверх ногами на потолке.
Двое мужчин танцуют.	Две женщины делают покупки.
Кто-то приправляет яйца.	Кто-то приправляет два сырых яйца в миске.
Женщина чистит луковицу.	Женщина нарезает зеленый лук.
Человек перемешивает горшочек с рисом.	Человек чистит картошку.
Человек качается на веревке.	Гиббон качается на деревьях.
Кто-то нарезает лук.	Кто-то несет рыбу.
Мужчина нарезает помидоры.	Женщина режет брокколи.
Женщина варит креветки.	Женщина расчесывает волосы.
Мужчина режет картошку.	Мужчина нарезает картофель.
Мужчина танцует на дороге.	Человек танцует.
Олень перепрыгнул через забор.	Олень перепрыгивает через ограждение циклона.
Девушка танцует под дождем.	Женщина танцует под дождем.
Женщина пишет письмо.	Женщина сидит за столом.
Горилла играет на барабанах.	Обезьяна играет на барабанах.
Мужчина играет на гитаре.	Девушка играет на гитаре.
Женщина верхом на лошади.	Женщина собирает помидоры.
Львенок пытается забраться на забор.	Лев пытается перелезть через стену.
Мужчина разговаривает по мобильному телефону.	Парень говорит в микрофон.
Мужчина играет на гитаре.	Мужчина чистит компакт-диск.
Мальчик ножницами срезал траву у обочины.	Мальчик стрижет траву ножницами.
Женщина нарезает кубиками очищенный картофель, нарезанный толстыми полосками.	Женщина рубит очищенную картошку ломтиками.
Мужчина в очках разговаривает.	Мужчина в библиотеку и говорит.
Маленькая девочка, торгующая скутером.	Девушка на скутере.
Женщина срезала цветы.	Женщина режет брокколи.
Человек идет по каменной дорожке.	Мужчина шел по тротуару.
Кто-то наливает в кастрюлю куриный бульон.	Мужчина наливает бульон в кастрюлю.
Мужчина играет носом на клавиатуре.	Мужчина играет на пианино носом.
Человек играет на гитаре.	Кошка играет.
Животное начинает есть.	Животное прыгает.
Мужчина поднимает тяжести.	Мужчина поднимает штангу.
Мужчина бежит с автобусом.	Мужчина бежит с грузовиком.
Человек лазание по канату.	Мужчина сидит на скале.
Кошка играет на пианино.	Кошка лижет свою лапу.
Женщина танцует под дождем.	Женщина добавляет масло в блюдо.
Кошка сама себя моет.	Кошка лижет сама себя.
Мужчина пинает футбольный мяч.	Мужчина выполняет трюки с футбольным мячом.
Мужчины бегут наперегонки.	Гонщики бегут по трассе.
Женщина открывает окно.	Женщина смотрит в окно.
Мужчина режет помидоры на куски.	Женщина режет картошку.
Человек играет на флейте.	Женщина наносит подводку для глаз.
Женщина режет картошку.	Женщина нарезает морковь.
Трое мужчин танцуют один и тот же танец на улице.	Трое мужчин без рубашки танцуют на улице.
Цыпленок клюет мертвую мышь.	Петух клюет мертвую мышь.
Женщина нарезает лук.	Женщина рубит чеснок ножом.
Женщина тонко нарезает огурец.	Женщина нарезает помидор.
Человек нарезает хлеб кусочками.	Мужчина нарезает хлеб.
Женщина режет кабачок.	Женщина режет большой перец.
Женщина добавляет масло в рыбу.	Женщина верхом на лошади.
Женщина натирает морковь на терке.	Женщина накрывает свиную отбивную.
Кто-то убирает животное.	Женщина чистит креветки.
Человек играет на гитаре.	Мужчина чистит картошку.
Мужчина разговаривает по телефону.	Говорит мужчина.
Женщина курит.	Женщина готовит еду.
Мужчина ложится и стреляет из ружья.	Мужчина лежит на земле стреляет из винтовки.
Человек ставится в abulance.	Мужчина разливает пасту на тарелку.
Мужчина ныряет в бассейн.	Человек поет в микрофон.
Мужчина выстрелил пистолет.	Мужчина стреляет из дробовика.
Мужчина пожимает руку другому мужчине.	Мужчина пожимает руку другому мужчине.
Цель поражается огнем из пистолета.	В цель стреляли пулями.
Мужчина играет на гитаре.	Человек играет на флейте.
Человек картошку.	Мужчина играет на гитаре.
Женщина едет верхом на лошади.	Мужчина едет верхом на лошади по арене.
Самолет движется по взлетно-посадочной полосе.	Самолет приземляется на взлетно-посадочную полосу.
Женщина скользит в ванне с водой.	Женщина лежит на плоту.
Мужчина косит газон.	Мужчина смешивает людей.
Человек танцует.	Женщина делает зарядку.
Женщина делает зарядку.	Человек танцует.
Женщина чистит картофель.	Женщина бьет мужчину.
Человек играет на пианино.	Человек лежит на земле.
Женщина занимается балетом.	Женщина верхом на лошади.
Женщина наносит макияж.	Мужчина играет на гитаре.
Женщина режет лук.	Женщина весельной лодке.
Женщина нарезает большой перец.	Человек резать зеленый перец.
Женщина помешивая рис в кастрюле.	Кто-то кладет рис в кастрюлю.
Мальчик играет на скрипке на сцене.	Мальчик играет на музыкальном инструменте.
Женщина измеряет другую женщину.	Женщина измерила лодыжку другой женщины.
Человек кладет сыр в пиццу.	Мужчина брызгает измельченным сыром на пиццу.
Женщина кладет в кастрюлю плиты мяса.	Мужчина кладет куски мяса в полиэтиленовый пакет.
Мальчик играл на трубе.	Мальчик играет на трубе.
Человек верхом на лошади.	Человек на мотоцикле.
Человек смотрит на лист.	Мужчина нарезает овощи.
Женщина нарезает лук.	Женщина резала морковку.
Мужчина нарезает овощи.	Женщина нарезает картофель.
Кошка играет.	Женщина играет на флейте.
Мужчина едет на велосипеде.	Мужчина едет на велосипеде по парковке.
Группа выступает на сцене.	Группа играет и поет на сцене.
Человек выбирает дракона Комодо и кладет его в коробку.	Человек помещает младенца комодского дракона в контейнер.
Женщина нарезает рыбный пирог.	Женщина едет верхом на лошади.
Человек ест хлеб.	Человек играет на флейте.
Женщина готовит креветки.	Женщина танцует.
Женщина танцует.	Женщина нарезает имбирь.
Женщина подбрасывает кошку в воздух, а кошка свисает со стержня на потолке.	Человек подбрасывает кошку в воздух и она хватается за потолок.
Человек роняет камеру на эскелатор.	Мужчина бросает сумку вниз по эскалатору.
Большая черепаха идет пешком.	Черепаха прогуливается.
Мужчина делает зарядку.	Мужчина стреляет из винтовки.
Мужчина сжег флаг.	Мужчина стреляет из пистолета.
Мужчина толкает машину.	Женщина поет песню.
Человек ест дерево.	Мужчина добавляет масло в машину.
Собака говорит на камеру.	Собака ест арбуз.
Мужчина кладет два бумажных полотенца на бумажную тарелку.	Человек кладет бумаги на блюдо.
Мужчина и женщина идут пешком.	Мужчина и женщина держатся друг за друга.
Мужчина перерезает мечом веревку.	Человек slced через толстую веревку с мечом.
Мужчина поет и играет на гитаре.	Мужчина играет на гитаре.
Собака играет с игрушкой.	Собака ест кукла.
Мужчина разрезает бумагу.	Человек рвал бумагу.
Мужчина играет на фортепиано.	Парень чистит картошку.
Человек танцует.	Крыса работает.
Два мальчика разговаривают по телефону.	Женщина разговаривает по телефону.
Человек играет на гитаре.	Женщина чистит клубень.
Женщина нарезает лук.	А женщины нарезают лимоны.
Женщина верхом на лошади.	Мужчина бежит по канату.
Мужчина играет в футбол.	Мужчина рисует какие-то фигуры.
Женщина чистит апельсин.	Человек играет на флейте.
Мужчина играет в боулинг.	Котенок ходит.
Кто - то разбивает яйцо.	Человек с яйцом.
Мужчина режет змею, чтобы приготовить.	Женщина резала мясо.
Мужчина играет на клавишных.	Человек играет на гитаре.
Женщина наносит тени для век.	Женщина моет посуду.
Женщина скребет морковь.	Мужчина бьет глиняные горшки.
Женщина играет на флейте.	Мужчина играет на клавишных.
Человек верхом на лошади.	Женщина на слоне.
Мужчина и женщина танцуют в Болливуде.	Мужчина и женщина танцуют под дождем.
Женщина срезает цветы.	Человек держит в руках огромные подсолнухи.
Женщина танцует у костра.	Женщина резки помидоров.
Мужчина танцевал в закусочной.	Бомба взорвалась в пустыне.
Человек играет на флейте.	Человек танцует.
Развевается американский флаг.	Американский флаг развевается на ветру.
Лев гуляет на закрытой территории.	Лев разгуливает вокруг.
Тигр ходит вокруг своей клетки.	Тигр бесцельно ходит вокруг.
Человек наливает в кастрюлю растительное масло.	Человек наливает оливковое масло в кастрюлю на плите.
Женщина режет картошку.	Женщина верхом на лошади.
Женщина нарезает лимон.	Человек показывает хлеб.
Человек делает кровать.	Мужчина выступает перед аудиторией.
Попугай разговаривает.	Попугай говорит в микрофон.
Женщина играет на флейте.	Женщина нарезает тунца.
Человек едет на мотоцикле.	Человек рубит лук.
Человек поет в микрофон.	Человек танцует под дождем.
Мужчина наливает рис в кастрюлю.	Мужчина кладет рис в горшок для боулинга.
Собака лает на игрушку.	Собака лает на игрушечную утку.
Женщина добавляет яйцо и перемешивает.	Женщина смешивает яйцо в миске.
Женщина накрывает кусок мяса мукой.	Женщина приправой кусок мяса.
Человек нарезает чеснок.	Человек нарезает ножом зубчик чеснока.
Белая кошка, сидящая на небольшом деревянном шкафу, смотрит в окно.	Кошка, усевшись на стол, смотрит в окно.
Женщина делает зарядку.	Женщина поднимает тяжести.
Мужчина делает вольные упражнения.	Человек осуществляет.
Ребенок бежит в и из океанских волн.	Мальчик бежит навстречу и от океанских волн.
Мужчина нарезает картофель.	Человек чистит банан.
Человек играет на пианино.	Мужчина играет на деревянной флейте.
Парень верхом на лошади.	Мужчина едет верхом на лошади по пустыне.
Кто-то играет на пианино.	Человек играет на клавишных.
Женщина наносит макияж мужчине.	Женщина рисует лицо человека.
Женщина опустила баклажаны на сковороду.	Женщина кладет нарезанные баклажаны в сотейник.
Собака ворует еду из холодильника.	Собака достала что-то из холодильника.
Мужчина играет на трубе.	Человек играет на музыкальном инструменте.
Человек использует паяльную лампу на двух камерах.	Человек сжигает камеры.
Женщина нарезает лимон.	Женщина на кухне чистит лимон.
Тигр пытается взобраться на стену.	Лев пытается перелезть через стену.
Мужчина готовит висячую веревку.	Человек завязывает петлю.
Женщина танцует на сцене.	Женщина танцует.
Женщина нарезает имбирь.	Женщина режет картошку.
Мужчины играют в футбол.	Две команды играют в футбол.
Девушка едет верхом на лошади.	Девочка опрыскивает растения водой.
Мужчина кладет нож в тиски.	Мужчина садится в машину в гараже.
Человек жарке.	Человек чистит картошку.
Мужчина стреляет из пистолета.	Женщина рубит чеснок.
Женщина размахивая руками.	Женщина нарезает лук.
Мужчина идет по улице.	Человек танцует.
Женщина готовит мясо.	Человек говорит.
Мужчина сушит свои руки.	Женщина поправляет волосы.
Футболист пинает футбольный мяч в ворота из долгого пути вниз по полю.	Футболист забивает мяч в ворота.
Человек чистит кабачки.	Женщина чистит кабачки овощной щеткой.
Щенок пытается выбраться из раковины.	Щенок пытался выбраться из ванны.
Девочка играет на фортепиано.	Маленькая девочка играет на рояле на сцене.
Мужчина рисует какие-то фигуры.	Человек рисует на цифровой доске сухого стирания.
Обезьяна висит на деревьях.	Обезьяна качнулась, с ветки на ветку.
Некоторые дети прыгают на батуте.	Два мальчика играют на батуте.
Человек складывает квадратный лист бумаги.	Человек складывает лист бумаги.
Женщина с ножом нарезать перец.	Женщины нарезают зеленый перец.
Панда жует палочку - КР.	Ребенок панда играет с палкой.
Мужчина добавляет масло в машину.	Мужчина ставит антифриз в машину.
Люди поднимают мешки.	Несколько человек несут большие сумки.
Мальчик играет на пианино.	Женщина наливает масло в сковороду.
Мужчина разговаривает по телефону.	Человек-Луна, идущая через магазин.
Мужчина нарезает морковку у станка.	Человек лазание по канату.
Мальчик играл на клавиатуре.	Человек играет на фортепианной клавиатуре.
Кот играет с антенной.	Мальчик играет в грязи.
Женщина нарезает тыкву.	Человек нарезает дыню.
Женщина заплетает волосы.	Человек на мотоцикле.
Человек резки картофеля.	Женщина поднимается по каменной стене.
Женщина кормит ребенка.	Человек добавляет воду в кастрюлю.
Мужчина играет на гитаре.	Женщина верхом на лошади.
Люди бросили манекен через край обрыва.	Некоторые люди бросают манекен со скалы.
Пушки стреляют.	Картофель очищается.
Женщина смешивает яйца.	Женщина начинает есть.
Женщина резки пластиковый лист.	Женщина играет на гитаре на улице.
Женщина разрезает ананас.	Женщина нарезает ананас на кусочки.
Женщина добавляет специи к мясу.	Женщина добавляет ингредиенты в говядину.
Человек добавляет масло в кастрюлю.	Повар наливает масло в кастрюлю.
Повар приправляет тесто.	Человек приправляет тесто на сковороде.
Мальчик бежит по пляжу.	Два мальчика играют на пляже.
Маленькая обезьянка чешет себя.	Обезьяна почесала животик.
Мужчина бросает ножи в дерево.	Мужчина метает клинки в близкую цель снаружи.
Мальчик едет на велосипеде по воротам.	Женщина верхом на лошади.
Женщина нарезает тофу.	Женщина красит губы.
Мужчина катался на лодке.	Мужчина связывает в машине.
Женщина складывает бумагу.	Женщина наносит тени для век.
Кто-то складывает лист бумаги.	Человек нарезает небольшие кусочки имбиря.
Человек делает карточный трюк.	Мужчина сжимает воду.
Человек играет на пианино.	Кто-то играет на гитаре.
Мужчина поднимает тяжести.	Мужчина рубит яичный завод.
Мужчина косит траву.	Парень стрижет газон.
Человек смешивает воду и муку.	Человек едет автостопом по дороге.
Две собаки были в загоне.	Ковбой скакал на лошади по пустыне.
Мужчина едет на одном колесе на мотоцикле.	Человек выполняет трюки на мотоцикле.
Человек отбывает торт.	Мужчина приправляет перепелов.
Кошка открывает ящик и забирается внутрь.	Большой кот открывает пластиковый ящик лапами, а затем прыгает внутрь.
Кто-то пожирает морковку.	Женщина натирает на терке апельсиновую еду.
Человек открывает коробку с помощью ножа.	Мужчина играет на гитаре.
Человек пинает много воды.	Женщина нарезает красный перец.
Мужчина ест.	Женщина занимается скалолазанием.
Щенок неоднократно катится из стороны в сторону, находясь на спине.	Собака катится из стороны в сторону.
Мальчик поет и играет на гитаре.	Ребенок играет на гитаре.
Женщина чистит лимон.	Мужчина балансирует на проводе.
А человек играет на трубе.	Кто-то играет с жабой.
Мужчина стоит на крыше дома и играет на скрипке.	Мужчина на крыше танцует.
Собака оглядывается.	Cобака наблюдает за прилавком магазина.
Женщина нарезает лук.	Мужчина показывает нарезку моркови ножом.
Мужчина просверлил отверстия в лесу.	Мужчина сверлит дерево.
Кто - то вырезает круг из розового листа бумаги.	Кто-то наливает томатный соус в кастрюлю с мясом.
Человек играет на флейте.	Мужчина гладит привязанную собаку.
Человек ставит мясо в пакетик.	Человек drivong автомобиль.
Девушка ест кекс.	Человек играет на трубе.
Кролик нюхает и лапает чучело кролика.	Живой кролик играет с плюшевым животным кроликом.
Мужчина намазывает хлеб маслом.	Женщина ridint лошадь.
Обезьяна карате ногами человека.	Обезьяна увлекается боевыми искусствами.
Женщина сжимает кусочки огурца.	Женщина обливается зеленой слизью.
Мужчина достает внутренности зеленого перца.	Кто - то вынимает семена из болгарского перца.
Человек берет кусок пиццы Пепперони из коробки для пиццы и кладет его на крышку после того, как он закрывает коробку.	Мужчина достал из коробки кусок пиццы с пепперони.
Мужчина добавил овощи в бульон в кастрюле.	Мужчина добавляет нарезанные овощи в миску с водой.
Мужчина побежал и прыгнул к стене.	Мужчина прыгает в стену.
Мужчина играет на виолончели.	Мужчина стремительно поднимает небольшие тяжести.
Говорит мужчина.	Мужчина спускается по лестнице.
Мужчина пытается скормить мышь змее.	Мужчина дразнит змею мышкой.
Человек заправляет сосиски.	Мужчина добавил приправу к воде в миску.
Клоун поет, люди танцуют.	Клоун поет.
Женщина кормит трубкозуба.	Женщина рубит чеснок.
Человек shappens нож.	Мужчина несет женщину.
Человек ополаскивает стейк водой.	Мужчина полоскает большой стейк.
Мальчик ехал на велосипеде по металлическому забору.	В BMX байкер едет по верху забора.
Мужчина бросает ножи в дерево.	Человек показывает магию.
Мужчина играет на барабанах.	Женщина нарезает листья.
Женщина расчесывает ноги.	Женщина нарезает лук.
Мужчина играет на гавайской гитаре.	Мужчина сидит и играет на маленькой гитаре.
Девочки идут на сцену.	Женщины-модели идут по подиуму.
Женщина делает упражнения с весом.	Женщина, осуществляющих с штангой.
Мужчина чистит картошку.	Мужчина идет в поход.
Большая птица, стоящая на столе, поднимает пластиковый стакан с жидкостью и помещает его в миску с чем-то.	Птица поднимает клювом пластиковый стакан с жидкостью и кладет его в чашу.
Женщина находится под дождем.	Автомобиль едет по дороге.
Женщина бьет мужчину.	Мужчина держит в руках медленную Лорис.
Женщина на слоне.	Человек поднимает себя.
Мужчина поднимает тяжести.	Женщина тренирует свой пресс.
Человек едет на водном мотоцикле по волнам.	Женщина едет верхом на seadoo.
Женщина снимает кожу с какого-то мяса.	Женщина нарезает помидор.
Женщина носить наушники.	Женщина рубит листья шисо.
Котенок пьет молоко из миски.	Маленький ребенок пьет воду из чашки.
Котенок ест свою пищу из тарелки.	Котенок ест немного еды.
Женщина читает журнал о стиле жизни.	Женщина нарезает мясо на куски.
Мужчина наливает Чили в миску.	Человек открывает банку и выливает содержимое в миску.
Человек перемешивает ингредиенты в миске.	Мужчина взбивает вилкой два яйца в миске.
Птица ела пищу на дереве из миски.	Птица ест из миски.
Группа девушек выходит из такси.	Видео с Рианной, покидающей такси.
Человек разбивает шлакоблоки на другого человека.	Женщина разбивает яйцо о сковороду.
Женщина приправой кусок мяса.	Мужчина заряжает винтовку пулями.
Женщина отдыхает в ванной.	Женщина колет картошку вилкой.
Женщина добавляет масло в рыбу.	Женщина режет картошку.
Женщина что-то пишет.	Женщина рубит зеленый лук.
Мужчина рубит лист кориандра.	Мужчина играет на гитаре.
Мужчина берет кусок пиццы.	Мужчина разговаривает по мобильному телефону.
Мужчина кладет мясо в пластиковый пакет.	Женщина несла в кенгуру в сумку.
Ребенок ест свою пищу.	Ребенка кормят горохом.
Мужчина нарезает морковку у станка.	Мужчина стоит под дождем.
Раввин говорит.	Человек идет по канату.
Мужчина едет верхом на лошади.	Женщина трет ножку ребенка.
Человек играет на гитаре.	Smeone падает.
Человек разрезает булочку.	Мужчина бьет горшки.
Мужчина за рулем автомобиля.	Женщина макает креветку в тесто.
Собака лапает муху на ковре перед собой.	Собака играла с жучком на ковре.
Собака лает.	Реактивный самолет летит.
Мужчина играет на гитаре и поет на сцене.	Человек играет на электрогитаре.
Обезьяна гуляет по кровати.	Человек верхом на лошади.
Женщина готовит брокколи.	Человек ест свою пищу.
Мужчина бьет мальчика вазой с цветами.	Человек режущий мат.
Мальчик играет на пианино.	Мужчина поет и играет на гитаре.
Мужчина жарит тортилью.	Человек выполняет карточный трюк.
Женщина, обслуживающая волейбольные мячи через сеть.	Одна женщина вручает волейбольные мячи другой женщине, которая их обслуживает.
Человек начинает пожар.	Человек добывает огонь.
Мужчина нарезает огурец ножом.	Мужчина готовит тортилью на сковороде.
Мужчина играет на электронной клавиатуре.	Оркестр играет на инструментах.
Мужчина смешивает взбитые сливки.	Мужчина держит в руках скунса.
Человек играет на скрипке.	Ребенок смеется и ползает.
Человек помешивая сок.	Мужчина чистит лук.
Мужчина отрезает палец пустого кожаного ботинка мечом.	Мужчина режет сапог мечом.
Кто-то разрезает две сырые грудинки ребер.	Кто-то режет кусок мяса.
Человек снимает чешую с рыбы.	Человек очищает рыбу от накипи.
Люди идут в сад.	Один мальчик разговаривает с другим мужчиной.
Маленький ребенок едет на лошади.	Маленькая девочка каталась на лошади.
Человек режет ножом чеснок на куски.	Кто-то кладет ингредиенты в вок.
Мужчина складывает бумажку.	Мужчина нарезает пластиковый контейнер мечом.
Мужчину столкнули в воду.	Человек толкает другого человека в океан.
Мальчик расстроен, играя в видеоигры.	Кто-то играет в геймбой.
Мужчина звонит по мобильному телефону.	Мужчина делает телефонный звонок.
Мужчина говорит по телефону.	Панда жует палочку - КР.
Мужчина пинает кастрюли с водой.	Мужчина переворачивает продукты.
Женщина наносит косметику на лицо.	Женщина наносит макияж.
Мужчина поднял штанги.	Мужчина поднимает тяжести.
Две маленькие девочки разговаривают по телефону.	Две пары разговаривают друг с другом.
Кошка застревает на движущемся потолочном вентиляторе.	Кошка качается на вентилятор.
Кошка пьет молоко.	Белая кошка лижет и пьет молоко, хранящееся на тарелке.
Женщина кормит животное вручную.	Женщины кормят животное.
Женщина едет верхом на лошади по берегу моря.	Женщина моет посуду.
Человек рубит траву.	Человек мелко рубит зеленую субстанцию.
Несколько хорьков вылезают из клетки.	Хорьки спускаются с полки.
Женщина собирает воду из-под крана в кружку.	Мальчик наполняет кувшин водой.
Молодая женщина играет на флейте.	Женщина смывает верхнюю часть морозильной камеры.
Женщина стреляет из дробовика.	Женщина стреляет из винтовки.
Человек взбивая яйца в миске.	Женщина бьет два яйца в миске проволочным венчиком.
Человек добавляет порошок чили в Чили с фасолью.	Человек добавляет приправу к бобам.
Женщина быстро стреляет из пистолета.	Женщина стреляет из ружья.
Человек нарезает лук.	По земле идет соленодон.
Рокки и Аполло Крид бегут по пляжу.	Мужчины бегают трусцой по пляжу.
Мужчина пел играя на гитаре.	Человек набивает себя едой.
Собака не могла понять, как вытащить палку из собачьей двери.	Собака пытается пройти через дверь своей собаки.
Собака открывает холодильник.	Собака закрывает дверцу холодильника.
Женщина смешивает яйца в миске.	Мужчина делает отжимания.
По воде плывет лодка.	Человек играет на гитаре.
Женщина держит танцующего ребенка на руках.	Женщина жестоко обращается со своим ребенком.
Женщина делает Джокер макияж мужчине.	Девушка нанесла макияж лица мужчине.
Дама добавила сыр в соус.	Мужчина наливает тарелку измельченного сыра в кастрюлю с соусом.
Мужчина читает лекцию на трибуне.	Человек читает лекцию на мероприятии, посвященном игре в крикет.
Кошка бегает под кроватью.	Кошка ползет вверх ногами под диваном.
Окапи ест с дерева.	Лось пьет из разбрызгивателя.
Женщина рубит чеснок.	Женщина ломтики рыбы.
Мужчина стрижет траву.	Поет человек в маске.
Мужчина стрижет траву.	Клоун поет.
Мальчик убегает от лески.	Мальчик бежит перед висящей на удочке рыбой.
Несколько детей прыгают вверх и вниз на батуте.	Человек делает сальто назад на батуте.
Мужчина играл хаки Сака в офисе.	Человек приправляет овощи.
Мужчина несет другого мужчину на спине.	Мужчина фотографирует муравьев.
Дама сделала несколько ломтиков креветок.	Шеф-повар нарезает креветки.
Женщина наливает яйцо на сковороду.	Мужчина гладит двух собак.
Женщина жарит мясной фарш.	Мужчина рубит топором сундук.
Мясо опускают в кастрюлю.	Женщина кладет мясо в кастрюлю.
Женщина режет лук-шалот.	Женщина падает на замок из песка.
Мужчина бьет по мячу.	Женщина нарезает лук.
Машина заточки карандаша.	Девушка едет на велосипеде.
Женщина расчесывает ноги.	Солнце встает за деревьями.
Мужчина моет окна.	Мужчина за рулем автомобиля.
Кто-то смешивает жидкость.	Мужчина играет на гитаре.
Человек помешивая рис.	Женщина разбивает яйцо.
Три мальчика в костюмах каратэ борются.	Трое мужчин практикуют каратэ в поле.
Мужчина кладет нож в тиски.	Человек танцует.
Мальчик играет на скрипке на сцене.	Мальчик на сцене играет на скрипке.
Женщина режет ножом розовый каравай.	Мужчина играет на гитаре.
Мужчина добавляет свиные отбивные на сковороду.	Женщина чистит картофель.
Мужчины сражаются друг с другом.	Мужчина нарисовал на белой бумаге.
Мужчина ловит мяч.	Кошка трутся о ребенка.
Девушка читает газету.	Шеф-повар чистит картошку.
Медленный Лорис кусает пальцы человека.	Маленькое животное жует палец.
Человек идет по тропинке через пустыню.	Мужчина чистит лук.
Мужчина играл на своей гитаре.	Парень поет, играя на гитаре.
Пловцы мчатся по озеру.	Женщины-пловчихи ныряют со стартовой платформы.
Некоторые мужчины катаются на коньках по дороге.	Два мальчика катаются на коньках.
Мужчина наливает жидкость в кастрюлю.	Повар налил масла в сковородку.
Мальчик играет на пианино и поет.	Свинья агитирует Льва.
Женщина нарезает большой перец.	Мужчина играет на музыкальном инструменте.
Человек варит лапшу.	Кошка лижет бутылку.
Кошка и хорек играют.	Хорек и котенок играют вместе.
Обезьяна идет по воде.	Парень играет на трубе.
Женщина наносит макияж.	Группа поет.
Человек нарезает лук.	Женщина рубит травы.
Собака за рулем автомобиля.	Парень говорит в микрофон.
Мужчина пел на сцене в микрофон.	Мужчина в костюме стоит у микрофона и поет.
Машина возвращается из космоса.	Машина едет задним ходом.
Животное с большими глазами ест.	Медленная Лорис ест.
Мужчина держит лягушка.	Мужчина опорожняет пластиковый контейнер.
Ребенок ползет радостно.	Кошка идет по деревянному полу.
Мужчина едет в лодке.	Женщина режет ножом морковку - КР.
Мужчина ехал на мотоцикле по шоссе.	Человек едет на мотоцикле по дороге.
Клуб тигра играет с мячом.	Человек рубит креветки ножом.
Мужчина наматывает рыбу катушкой.	Женщина наливает масло в миску.
Мужчина нарезает кубиками лук.	Человек играет на гитаре.
Мужчина выступает на сцене.	Человек потрошит рыбу.
Женщины начинают жалеть.	Две женщины сидят рядом друг с другом и разговаривают.
Женщина нарезает фрукты.	Две женщины нарезают лимоны.
Мужчина достает из пластикового пакета пару яичниц-тостеров.	Мужчина достает еду из сумки.
Флаг двигался в воздухе.	Развевается флаг.
Женщина танцует у костра.	Мужчина завязывает петлю.
Человек медитирует.	Мужчина едет верхом на лошади.
Женщина режет лук.	Лошадь стоит.
Мальчик режет бумагу.	Человек заряжает ружье.
Женщина смешала мясную смесь в миске.	Женщина помешивая мясо в миску.
Мужчина разговаривал по телефону.	Девочки идут на сцену.
Человек играет на гитаре и поет.	Человек открывает упаковку с наушниками.
футболист пнул мяч из стороны в сторону между ног.	Человек пинает футбольный мяч взад и вперед между его ногами.
Ребенок рассмеялся на своем автокресле.	Ребенок смеется.
Животное гуляет.	Женщина наносит макияж глаз.
Девушка наносит макияж на лицо.	Женщина наносит макияж.
Кто-то чешет животным живот.	Женщина гладила лемура.
Мужчина поднимает тяжелый груз.	Валлаби лижет руку женщины.
Собака дважды сбивает мальчика с ног.	Собака толкает малыша в лужу.
Женщина наносит макияж.	Женщина наносит тени для век.
Мальчик играет с игрушкой.	Мальчик играет в карманную игру.
Человек ныряет со скалы.	Человек на мотоцикле.
Кошка играет в воде.	Кот выловил соломинку из водяной тарелки.
Птица принимает ванну под краном.	Птица купается в раковине.
Мужчина играет на гитаре и поет.	Мужчина поет и играет на гитаре.
Человек выходит в воду.	Человек поднимается из болота.
Мужчина и женщина танцуют.	Человек гладит собаку.
Мужчина подметает пол дома длинной метлой.	Мужчина прочесал пустую гостиную.
Группа пар танцует.	Мужчины и женщины танцуют медленно.
Мужчина чистит рыбу.	Мужчина наливает в кастрюлю растительное масло.
Человек добавляет еду в кастрюлю.	Человек танцует на улице.
Мужчина установил камеру, чтобы фотографировать закат на пляже.	Мужчина фотографирует озеро.
Человек курит.	Ребенок сосет соску.
Женщины держат друг друга и танцуют вместе.	Двое мужчин играют в настольный теннис.
Кто-то держит и гладит тигренка.	Кто-то моет большой бифштекс у кухонной раковины.
Человек играет на гитаре.	Кот вытер ему лицо лапой.
Мужчина отжимался на стене.	Мужчина ударил шокером по еде.
Женщина режет овощи.	Женщина нарезает яичное растение.
Человек кладет измельченный сыр в кастрюлю.	Хомяк ест семена.
Мужчина пытается накормить змею мышкой.	Мужчина работает над своим ноутбуком.
Человек разбивает яйцо на маленькую миску.	Мужчина разбивает яйцо.
Мужчина играет на клавишных.	Мужчина катается на механическом быке.
Собака бегает во дворе.	Черная собака бегает в саду дома.
Ребенок идет по улице, подъезжает джип.	Женщина идет по дороге, рядом подъезжает мужчина на мотоцикле.
Мужчина стирает доске.	Женщина танцует, и поет.
Мужчина добавляет масло в кастрюлю.	Собака ловит рыбу в реке.
Девушка танцевала перед костром.	Женщина танцует под музыку, стоя у костра.
Мужчина делает зарядку.	Мужчина делает подтягивания.
Человек рубит масло в контейнер.	Женщина режет креветки.
Девушку тащит под гору собака.	Собака тянет ребенка вниз холм.
Мужчина снял солнечные очки во время разговора.	Мужчина в каске снимает очки, когда говорит.
Двое мужчин сделали смешной пародию с боксером перед толпой людей.	Мальчики танцуют перед людьми.
Девушка заправляет постель.	Женщина застилает постель.
Someoen готовит лук.	Мужчина размахивает нунчаками.
Человек использует sledghammer для того чтобы сломать бетонный блок который на другом человеке.	Мужчина разбивает бетонную плиту, которая лежит на лежащем на животе человеке с кувалдой.
Дама положила сушеную лапшу в горячую воду, чтобы приготовить.	Женщина кладет контейнер с лапшой в кастрюлю с водой.
Тигр играет со своим тренером.	Тигр нападает на человека.
Девушки танцевали на сцене.	Девушка наносит макияж.
Панда падает.	Ребенок панда расслабляется на некоторых бревнах.
Двое детей играют в бассейне с зеленым крокодиловым поплавком.	Двое детей толкают надувного крокодила в бассейне.
Пара полицейских поет караоке.	Две женщины танцуют.
Мужчина кладет брокколи в воду.	Человек чистит картошку.
Шимпанзе бьет по цели.	Женщина кладет масло в сковородке.
Доктор помогал пациенту.	Врачи пытаются оживить человека.
Некоторые натирают лук в воду.	Человек натирает картофель в миску.
Кошка играет с арбузом на полу.	Человек наливает масло на сковородку.
Мужчина делает зарядку.	Ребенок смеется.
Кошка извлекает предмет из тарелки с водой.	Кошка попыталась съесть кукурузу в початке.
Ребенок разговаривает.	Мальчик пытается сказать пожарная машина.
Девочка вынашивает ребенка.	Человек ест пищу.
Повар нарезает морковку.	Человек рисует картину.
Женщина варит яйца.	Женщина кладет два яйца в кастрюлю с водой.
Женщина кладет ингредиенты во взбитые яйца.	Мужчина разливает бензин.
Женщина нарезает манго.	Человек кладет сыр на тортилью.
Девушка нарезает масло на две части.	Женщина нарезает тофу.
Несколько пловцов прыгают в воду.	Пловцы мчатся по озеру.
Человек играет на гитаре.	Человек нарезает мясо на куски.
Мужчина крутится на доске для серфинга.	Мужчина кладет соус барбекю на курицу.
Человек открывает упаковку с наушниками.	Женщина верхом на лошади.
Девушка играет на гитаре.	Мальчик играет на доске для ключей между людьми.
Маленькая девочка играет на скрипке на пляже.	Девушка сидела на диване и вязала крючком.
Обезьяна-каратист, бьющий в чью-то руку в перчатке.	Обезьяна увлекается боевыми искусствами.
Женщина добавляет грибы и жидкость в кастрюлю.	Молодой человек играет на гитаре.
Мужчина страстно играет на гитаре перед аудиторией.	Женщина чистит картофель.
Женщина прикладывает что-то к волосам руками.	Кошка ест кусок арбуза.
Молодой человек едет на скейтборде и прыгает на тротуар, а затем прочь на другой бордюр.	Человек катается на скейте.
Человек каратэ ногами на другого человека, носить защитные боксерские перчатки.	Мужчина ведет кикбоксинг с тренером.
Кто-то нарисовал лицо Вашингтона на долларе.	Человек рисует на долларовой купюре.
Девушка нарезает лук.	Женщина рубит лук на мелкие кусочки.
Человек обмакивает апельсиновый перец.	Повар нарезает болгарский перец.
Мужчина играет на деревянной флейте.	Маленький мальчик пылесосит пол.
Молодая женщина играет на гитаре.	Женщина режет мясо.
Мужчина целится из пистолета.	Мальчик играет на игрушечном телефоне.
Мужчины играют в футбол.	Человек на мотоцикле.
Двое мужчин танцуют вместе.	Женщина открывает шкаф-купе.
Женщина работает на пляже.	Собака плавает в бассейне.
Мужчина читает электронное письмо.	Человек, открывающий банан.
Мужчина процеживает макароны.	Мужчина играет на деревянной флейте.
Панда играет на качелях.	Человек играет на гитаре.
